theme : situator
  accompanier : accompanied
  compared : reference
    asserted : conceded
    same : same-as
  follows : followed
    reproduction : original
    has-condition : condition
      has-exception: exception
    experiencer : experienced
    explained : explanation
    purpose : means
    result : causer
      reaction : trigger
      sent : sender
  has-location : landmark
    contained : container
    on-surface : surface
    wrapper : wearer
  has-property : property
    exists : existence
    has-aspect : aspect
      changes : change-aspect
      initiated : init-aspect
      deinitiated : deinit-aspect
      continued : cont-aspect
    has-class : class
    has-focus : focus
    has-mode : mode
      necessary : nec-mode
      negated : neg-mode
      possible : poss-mode
    has-identifier : identifier
    has-quantity : quantity
    has-rank : rank
    has-state : state
  topic : message
  part : whole
    stuff : made-of-stuff
  specific : generic
  has-social-role : social-situator
    possessed : possessor
  has-time : time

  asset : has-asset
  


asset : has-asset
pertains : pertained-to
*
